{
  "levels": [
    {
      "level": 1,
      "name": "Starlight Intro",
      "map": [
        [0,0,0,0,0,3,0,0,0,3,0,0,0,0,0,0],
        [0,0,0,4,1,1,1,1,1,1,1,1,4,0,0,0],
        [0,0,1,2,1,1,1,1,1,1,1,1,2,1,0,0],
        [0,1,1,1,1,3,1,1,1,1,3,1,1,1,1,0],
        [0,0,1,2,1,1,1,1,1,1,1,1,2,1,0,0],
        [0,0,0,1,1,1,1,1,1,1,1,1,1,0,0,0],
        [0,0,0,0,0,3,4,5,5,3,0,0,0,0,0,0],
        [0,0,0,0,0,0,0,0,0,0,0,0,0,0,0,0]
      ]
    },
    {
      "level": 2,
      "name": "Nebula Waves",
      "map": [
        [0,3,0,0,1,1,2,1,1,1,2,1,0,0,4,0],
        [0,0,1,1,1,3,1,1,1,1,3,1,1,1,0,0],
        [1,1,1,1,2,1,1,1,1,1,2,1,1,1,1,1],
        [0,3,0,1,1,4,1,1,1,1,3,1,1,0,4,0],
        [0,0,1,1,1,1,2,1,1,2,1,1,1,1,0,0],
        [0,0,0,4,0,0,1,1,1,1,0,0,5,0,0,0],
        [0,0,0,0,0,0,0,0,0,0,0,0,0,0,0,0],
        [0,0,0,0,0,0,0,0,0,0,0,0,0,0,0,0]
      ]
    },
    {
      "level": 3,
      "name": "Galaxy Ring",
      "map": [
        [0,0,3,3,4,3,3,0,0,3,2,2,4,3,0,0],
        [0,1,2,1,1,1,1,1,1,1,1,1,1,2,1,0],
        [4,2,3,0,0,0,0,0,0,0,0,0,3,2,4,0],
        [3,1,0,1,1,3,1,1,1,1,3,1,0,1,3,0],
        [3,1,0,1,1,3,1,1,1,1,3,1,0,1,3,0],
        [3,2,5,0,0,0,0,0,0,0,0,0,3,2,3,0],
        [0,1,2,1,1,1,1,1,1,1,1,1,1,2,1,0],
        [0,0,2,2,2,2,2,0,0,2,2,2,2,2,0,0]
      ]
    },
    {
      "level": 4,
      "name": "Comet Trail",
      "map": [
        [0,0,0,3,3,0,0,0,0,0,0,0,0,0,0,0],
        [0,1,1,1,1,1,3,1,1,1,1,1,1,0,0,0],
        [0,0,2,1,1,1,1,5,1,1,1,1,2,1,0,0],
        [0,0,0,3,1,1,1,1,3,1,1,1,1,3,0,0],
        [0,0,0,0,1,2,1,1,1,2,1,1,1,0,0,0],
        [0,0,0,0,0,2,3,3,3,3,3,2,0,0,0,0],
        [0,0,0,0,0,0,3,4,2,3,0,0,0,0,0,0],
        [0,0,0,0,0,0,0,0,0,0,0,0,0,0,0,0]
      ]
    },
    {
      "level": 5,
      "name": "Star Spiral",
      "map": [
        [0,0,3,3,0,0,0,0,0,0,3,3,0,0,0,0],
        [0,1,1,1,3,1,1,1,1,3,1,1,1,0,0,0],
        [0,0,2,1,1,1,3,1,3,1,1,2,1,1,0,0],
        [0,0,0,3,1,1,1,1,1,1,1,3,0,0,0,0],
        [0,0,0,0,1,2,5,1,3,2,1,0,0,0,0,0],
        [0,0,0,0,3,1,1,1,1,1,3,0,0,0,0,0],
        [0,0,0,0,0,4,2,2,3,2,0,0,0,0,0,0],
        [0,0,0,0,0,0,0,0,0,0,0,0,0,0,0,0]
      ]
    },
    {
      "level": 6,
      "name": "Supernova",
      "map": [
        [0,0,3,3,3,0,0,0,0,0,3,3,3,0,0,0],
        [0,1,1,2,1,3,1,1,1,1,3,1,2,1,1,0],
        [3,1,3,1,1,3,1,3,3,1,3,1,1,3,1,3],
        [3,1,3,1,3,3,3,4,3,4,3,3,1,3,1,3],
        [3,1,5,1,3,3,4,4,4,4,5,5,1,3,1,3],
        [3,1,3,1,1,3,1,3,3,1,3,1,1,3,1,3],
        [0,1,1,2,1,3,1,1,1,1,3,1,2,1,1,0],
        [0,0,3,3,3,0,0,0,0,0,3,3,3,0,0,0]
      ]
    },
    {
      "level": 7,
      "name": "Orbit Path",
      "map": [
        [0,3,0,0,1,1,2,1,3,1,2,1,1,0,0,3],
        [0,0,1,3,1,1,1,1,1,1,1,1,3,1,0,0],
        [3,1,2,1,1,3,3,3,3,3,3,1,1,2,1,3],
        [3,1,1,1,2,4,4,1,1,4,4,2,1,1,1,3],
        [3,1,2,1,1,3,5,3,3,5,3,1,1,2,1,3],
        [0,0,1,3,1,1,1,1,1,1,1,1,3,1,0,0],
        [0,3,0,0,1,1,2,1,3,1,2,1,1,0,0,3],
        [0,0,0,0,0,0,0,0,0,0,0,0,0,0,0,0]
      ]
    },
    {
      "level": 8,
      "name": "Galactic Core",
      "map": [
        [2,2,3,3,3,2,2,5,3,3,2,2,3,3,3,2],
        [2,1,1,1,1,2,1,1,1,1,2,1,1,1,1,2],
        [3,1,4,4,1,3,1,4,4,1,3,1,4,4,1,3],
        [3,1,1,1,1,3,1,1,1,1,3,1,1,1,1,3],
        [3,1,4,4,1,3,1,4,4,1,3,1,4,4,1,3],
        [2,1,1,1,1,2,1,1,1,1,2,1,1,1,1,2],
        [2,2,3,5,3,2,2,3,3,3,2,2,3,5,3,2],
        [0,0,0,0,0,0,0,0,0,0,0,0,0,0,0,0]
      ]
    },
    {
      "level": 9,
      "name": "Black Hole Edge",
      "map": [
        [0,3,3,3,3,3,3,3,3,3,3,3,3,3,3,0],
        [3,4,4,4,4,4,4,4,4,4,4,4,4,4,4,3],
        [3,4,1,1,1,1,1,1,1,1,1,1,1,1,4,3],
        [3,4,1,2,1,3,3,3,3,3,3,1,2,1,4,3],
        [3,4,1,2,1,5,3,5,3,5,3,1,2,1,4,3],
        [3,4,1,1,1,1,1,1,1,1,1,1,1,1,4,3],
        [3,4,4,4,4,4,4,4,4,5,4,4,4,4,4,3],
        [0,3,3,3,3,3,3,3,5,3,3,3,3,3,3,0]
      ]
    },
    {
      "level": 10,
      "name": "Final Starburst",
      "map": [
        [3,3,3,3,3,3,3,3,3,3,3,3,3,3,3,3],
        [3,4,4,4,4,4,4,4,4,4,4,4,4,4,4,3],
        [3,4,2,1,1,1,1,1,1,1,1,1,1,2,4,3],
        [3,4,1,3,5,3,4,5,4,3,3,3,1,3,4,3],
        [3,4,1,3,3,3,4,4,4,5,3,3,1,3,4,3],
        [3,4,2,1,1,1,1,1,1,1,1,1,1,2,4,3],
        [3,4,4,4,4,5,5,4,4,4,4,4,4,4,4,3],
        [3,3,3,3,3,3,3,3,3,3,3,3,3,3,3,3]
      ]
    }
  ]
}
